111111111111111111111
1P10000010000000001E1
1010101010000C0001001
1010101001C0000100001
100010000001000C00001
111111111111111111111