1111111111111
1P000000C0001
1000011000011
10000110000E1
1000011000011
1000000000001
1111111111111