1111111111111
1P000000C1E11
1000011000011
1000011000001
100001100C011
10C0000000001
1111111111111