111111111111111111111
1P010000C0000000001E1
100001100000010100001
100001100100010100001
100001100000000000001
111111111111111111111