1111111111111
1P010000C0001
10000110000E1
1000011000001
1000011000001
1111111111111