11111111111111111111111111111111111111111111111111111
1P0000000000000000000000000000000000000000000000000E1
10000000000000000000C0000000000000000000000000C000001
10000000000000000000C0000000000000000000000000C000001
10000000000000000000C0000000000000000000000000C000001
10000000000000000000C0000000000000000000000000C000001
10000000000000000000C0000000000000000000000000C000001
10000000000000000000C0000000000000000000000000C000001
10000000000000000000C0000000000000000000000000C000001
10000000000000000000C0000000000000000000000000C000001
10000000000000000000C0000000000000000000000000C000001
10000000000000000000C0000000000000000000000000C000001
10000000000000000000C0000000000000000000000000C000001
10000000000000000000C0000000000000000000000000C000001
10000000000000000000C0000000000000000000000000C000001
10000000000000000000C0000000000000000000000000C000001
10000000000000000000C0000000000000000000000000C000001
10000000000000000000C0000000000000000000000000C000001
10000000000000000000C0000000000000000000000000C000001
10000000000000000000C0000000000000000000000000C000001
10000000000000000000C0000000000000000000000000C000001
10000000000000000000C0000000000000000000000000C000001
10000000000000000000C0000000000000000000000000C000001
10000000000000000000C0000000000000000000000000C000001
10000000000000000000C0000000000000000000000000C000001
10000000000000000000C0000000000000000000000000C000001
10000000000000000000C0000000000000000000000000C000001
10000000000000000000C0000000000000000000000000C000001
11111111111111111111111111111111111111111111111111111