1111111111111
100100000C1C1
1000011000111
1P0011E000001
1111111111111