1111111111111
10010000000C1
1000001100001
1P00111E00001
1111111111111