1111111111111
1CC1CCCCCC1C1
1CCCC11CCCCC1
1CC11CCCCC1C1
1CC11CCCCC1C1
1C1C1CC1CC1C1
1C1C1CC11C1C1
1C1C1CC1C11C1
1C1C1CC1CCCC1
1C1C1111C1111
1CCCCCCCPCE01
1111111111111